#Codebook - mean summaries from Human Activity Recognition Using Smartphones Dataset

##Grouping variables
###Variable name       Detailed Label      Class          Values
activity            activity            factor          1 WALKING
                                                        2 WALKING_UPSTAIRS     
                                                        3 WALKING_DOWNSTAIRS
                                                        4 SITTING
                                                        5 STANDING
                                                        6 LAYING
                                                        
subject             subject             integer         1..30

##Activity Recognition Measurements - all 88 calculated means of means and stds normalised between -1.0 and +1.0
###Variable name                        Detailed Label      
tbodyaccmeanx_1	                        Time body accelerometer mean X  
tbodyaccmeany_2	                        Time body accelerometer mean Y  
tbodyaccmeanz_3	                        Time body accelerometer mean Z  
tgravityaccmeanx_41	                Time gravity accelerometer mean X  
tgravityaccmeany_42	                Time gravity accelerometer mean Y  
tgravityaccmeanz_43	                Time gravity accelerometer mean Z  
tbodyaccjerkmeanx_81	                Time body accelerometer jerk mean X  
tbodyaccjerkmeany_82	                Time body accelerometer jerk mean Y  
tbodyaccjerkmeanz_83	                Time body accelerometer jerk mean Z  
tbodygyromeanx_121	                Time body gyrometer mean X  
tbodygyromeany_122	                Time body gyrometer mean Y  
tbodygyromeanz_123	                Time body gyrometer mean Z  
tbodygyrojerkmeanx_161	                Time body gyrometer jerk mean X  
tbodygyrojerkmeany_162	                Time body gyrometer jerk mean Y  
tbodygyrojerkmeanz_163	                Time body gyrometer jerk mean Z  
tbodyaccmagmean_201	                Time body accelerometer mag mean 
tgravityaccmagmean_214	                Time gravity accelerometer mag mean 
tbodyaccjerkmagmean_227	                Time body accelerometer jerk mag mean 
tbodygyromagmean_240	                Time body gyrometer mag mean 
tbodygyrojerkmagmean_253                Time body gyrometer jerk mag mean 
fbodyaccmeanx_266	                Frequency body accelerometer mean X  
fbodyaccmeany_267	                Frequency body accelerometer mean Y  
fbodyaccmeanz_268	                Frequency body accelerometer mean Z  
fbodyaccmeanfreqx_294	                Frequency body accelerometer  mean freq X  
fbodyaccmeanfreqy_295	                Frequency body accelerometer  mean freq Y  
fbodyaccmeanfreqz_296	                Frequency body accelerometer  mean freq Z  
fbodyaccjerkmeanx_345	                Frequency body accelerometer jerk mean X  
fbodyaccjerkmeany_346	                Frequency body accelerometer jerk mean Y  
fbodyaccjerkmeanz_347	                Frequency body accelerometer jerk mean Z  
fbodyaccjerkmeanfreqx_373	        Frequency body accelerometer jerk  mean freq X  
fbodyaccjerkmeanfreqy_374	        Frequency body accelerometer jerk  mean freq Y  
fbodyaccjerkmeanfreqz_375	        Frequency body accelerometer jerk  mean freq Z  
fbodygyromeanx_424	                Frequency body gyrometer mean X  
fbodygyromeany_425	                Frequency body gyrometer mean Y  
fbodygyromeanz_426	                Frequency body gyrometer mean Z  
fbodygyromeanfreqx_452	                Frequency body gyrometer  mean freq X  
fbodygyromeanfreqy_453	                Frequency body gyrometer  mean freq Y  
fbodygyromeanfreqz_454	                Frequency body gyrometer  mean freq Z  
fbodyaccmagmean_503	                Frequency body accelerometer mag mean 
fbodyaccmagmeanfreq_513	                Frequency body accelerometer magmean freq 
fbodybodyaccjerkmagmean_516	        Frequency body accelerometer jerk mag mean 
fbodybodyaccjerkmagmeanfreq_526	        Frequency body accelerometer jerk magmean freq 
fbodybodygyromagmean_529	        Frequency body gyrometer mag mean 
fbodybodygyromagmeanfreq_539            Frequency body gyrometer magmean freq 
fbodybodygyrojerkmagmean_542            Frequency body gyrometer jerk mag mean 
fbodybodygyrojerkmagmeanfreq_552        Frequency body gyrometer jerk magmean freq 
angletbodyaccmean_gravity_555           angleTime body accelerometer  mean gravit Y  
angletbodyaccjerkmean_gravitymean_556	angleTime body accelerometer jerk  mean gravity mean 
angletbodygyromean_gravitymean_557	angleTime body gyrometer  mean gravity mean 
angletbodygyrojerkmean_gravitymean_558	angleTime body gyrometer jerk  mean gravity mean 
anglex_gravitymean_559	                angle X  gravity mean 
angley_gravitymean_560	                angle Y  gravity mean 
anglez_gravitymean_561	                angle Z  gravity mean 
tbodyaccstdx_4	                        Time body accelerometer std X  
tbodyaccstdy_5	                        Time body accelerometer std Y  
tbodyaccstdz_6	                        Time body accelerometer std Z  
tgravityaccstdx_44	                Time gravity accelerometer std X  
tgravityaccstdy_45	                Time gravity accelerometer std Y  
tgravityaccstdz_46	                Time gravity accelerometer std Z  
tbodyaccjerkstdx_84	                Time body accelerometer jerk std X  
tbodyaccjerkstdy_85	                Time body accelerometer jerk std Y  
tbodyaccjerkstdz_86	                Time body accelerometer jerk std Z  
tbodygyrostdx_124	                Time body gyrometer std X  
tbodygyrostdy_125	                Time body gyrometer std Y  
tbodygyrostdz_126	                Time body gyrometer std Z  
tbodygyrojerkstdx_164	                Time body gyrometer jerk std X  
tbodygyrojerkstdy_165	                Time body gyrometer jerk std Y  
tbodygyrojerkstdz_166	                Time body gyrometer jerk std Z  
tbodyaccmagstd_202	                Time body accelerometer mag std 
tgravityaccmagstd_215	                Time gravity accelerometer mag std 
tbodyaccjerkmagstd_228	                Time body accelerometer jerk mag std 
tbodygyromagstd_241	                Time body gyrometer mag std 
tbodygyrojerkmagstd_254	                Time body gyrometer jerk mag std 
fbodyaccstdx_269	                Frequency body accelerometer std X  
fbodyaccstdy_270	                Frequency body accelerometer std Y  
fbodyaccstdz_271	                Frequency body accelerometer std Z  
fbodyaccjerkstdx_348	                Frequency body accelerometer jerk std X  
fbodyaccjerkstdy_349                	Frequency body accelerometer jerk std Y  
fbodyaccjerkstdz_350	                Frequency body accelerometer jerk std Z  
fbodygyrostdx_427	                Frequency body gyrometer std X  
fbodygyrostdy_428	                Frequency body gyrometer std Y  
fbodygyrostdz_429	                Frequency body gyrometer std Z  
fbodyaccmagstd_504	                Frequency body accelerometer mag std 
fbodybodyaccjerkmagstd_517	        Frequency body accelerometer jerk mag std 
fbodybodygyromagstd_530	                Frequency body gyrometer mag std 
fbodybodygyrojerkmagstd_543	        Frequency body gyrometer jerk mag std 
